111111111111111111
100000000000011111
1P0000000000E11111
1CCCCCCCCCCCC00001
1CCCCCCCCCCCC00001
1CCCCCCCCCCCC11001
1CCCCCCCCCCCC11001
1CCCCCCCCCCCC11001
1CCCCCCCCCCCC11001
1CCCCCCCCCCCC11001
1CCCCCCCCCCCC11001
1CCCCCCCCCCCC11001
1CCCCCCCCCCCC00001
1CCCCCCCCCCCC00001
1CCCCCCCCCCCC11111
1CCCCCCCCCCCC11111
1CCCCCCCCCCCC11111
111111111111111111