111111
1E11C1
1P0101
101101
100001
1000C1
111111