11111111111111111111111111111111111111
111011110CC0111111101111111110C0111111
11111111C00C00000111111111111110001111
111000000C0111110001000C11110000111111
111011111111111000C0000000000111111111
1110000111111111000000C011110111111111
11111101111111111110111111110000001111
10000100011100001110111111110111100111
100P0C010111000000001111111000E1101111
1C000111000001001111111111100001C01111
11011111111100C0000001111100C000001111
110111111111000011110011111C0001111111
11010000011111111100011111111011111011
1100010C011110111101000000000011111111
1111C0000111111111C0011110111111110111
11111111111111111111111111111111111111