111111111111111111111
111111100111001111111
111000000000000000111
110P00000000000000011
1100C11001110011C0011
110011100111001110011
110011100111001110011
100000000000000000001
100000000000000000001
110011100111001110011
110011100111001110011
1100C11001110011E0011
110000000000000000011
111000000000000000111
111111100111001111111
111111111111111111111