111111111111111
1000001000000C1
101010101111111
101E10100000001
101110111111101
100000000000001
111110011111101
110P10010000001
11000001C000001
111111111111111