111111111111111111111111111111111111
101100000111101110111110000111110011
1110P0000001111100011000000001110111
1110001000001110000000000000C1101111
111100000110000011010011100011111111
111111101111000111111101111110111111
111011100111100111111111111111111111
111111110111110011000111111011111111
101111100110110000010001111111111111
111111001111111000111101100000110111
111111011111111111111000000000011111
111111000110111111E00001111100011111
111111011111111111100011111000011111
11101100111101000C111000000000111101
111111100111000000111110011100111111
101111000000001111111111001100C11111
111110100000111100111111001101101111
111110000000111111111110001001111111
11111C000001111100000100000011111111
111011100100111000100000001111111011
111111111110000011100C00001111111111
111111101111100001110000001111011111
110111111111000111111100000111111111
111111111110011110111111100011111111
111111110000111111111111111001111111
11000011101011111111111C011101111111
1100001110C0111111101110001001110111
110000111111110111111111100011111111
111111111111111111111111111111111111