111111111
1000000E1
100000001
1P000XYZ1
111111111