11111111111
1C0011100E1
10000100001
10000100001
10000100001
1P0011100C1
11111111111